[console_scripts]
CoverageOfEachTrans = RiboMiner.CoverageOfEachTrans:main
EnrichmentAnalysis = RiboMiner.EnrichmentAnalysis:main
EnrichmentAnalysisForSingleTrans = RiboMiner.EnrichmentAnalysisForSingleTrans:main
ExtractSequenceCenteredOnAPosition = RiboMiner.ExtractSequenceCenteredOnAPosition:main
GCContent = RiboMiner.GCContent:main
GetProteinCodingSequence = RiboMiner.GetProteinCodingSequence:main
GetUTRSequences = RiboMiner.GetUTRSequences:main
LengthDistribution = RiboMiner.LengthDistribution:main
MergeSampleDensitys = RiboMiner.MergeSampleDensitys:main
MetageneAnalysis = RiboMiner.MetageneAnalysis:main
MetageneAnalysisForTheWholeRegions = RiboMiner.MetageneAnalysisForTheWholeRegions:main
ModifyHTseq = RiboMiner.ModifyHTseq:main
OutputTranscriptInfo = RiboMiner.OutputTranscriptInfo:main
PausingScore = RiboMiner.PausingScore:main
Periodicity = RiboMiner.Periodicity:main
PlotEnrichmentRatio = RiboMiner.PlotEnrichmentRatio:main
PlotGCContent = RiboMiner.PlotGCContent:main
PlotHydropathyCharge = RiboMiner.PlotHydropathyCharge:main
PlotMetageneAnalysis = RiboMiner.PlotMetageneAnalysis:main
PlotMetageneAnalysisForTheWholeRegions = RiboMiner.PlotMetageneAnalysisForTheWholeRegions:main
PlotPolarity = RiboMiner.PlotPolarity:main
PlotRiboDensityAroundTriAAMotifs = RiboMiner.PlotRiboDensityAroundTriAAMotifs:main
PlotRiboDensityAtEachKindAAOrCodon = RiboMiner.PlotRiboDensityAtEachKindAAOrCodon:main
PlotTransCoverage = RiboMiner.PlotTransCoverage:main
PolarityCalculation = RiboMiner.PolarityCalculation:main
ProcessPausingScore = RiboMiner.ProcessPausingScore:main
RPFdist = RiboMiner.RPFdist:main
ReadsLengthOfSpecificRegions = RiboMiner.ReadsLengthOfSpecificRegions:main
RiboDensityAroundTripleteAAMotifs = RiboMiner.RiboDensityAroundTripleteAAMotifs:main
RiboDensityAtEachKindAAOrCodon = RiboMiner.RiboDensityAtEachKindAAOrCodon:main
RiboDensityAtEachPosition = RiboMiner.RiboDensityAtEachPosition:main
RiboDensityForSpecificRegion = RiboMiner.RiboDensityForSpecificRegion:main
RiboDensityOfDiffFrames = RiboMiner.RiboDensityOfDiffFrames:main
StatisticReadsOnDNAsContam = RiboMiner.StatisticReadsOnDNAsContam:main
cAI = RiboMiner.cAI:main
cAIPlot = RiboMiner.cAIPlot:main
enrichmentMeanDensity = RiboMiner.enrichmentMeanDensity:main
hydropathyCharge = RiboMiner.hydropathyCharge:main
tAI = RiboMiner.tAI:main
tAIPlot = RiboMiner.tAIPlot:main

