full_name	short_name	letter_name	indra_name
alanine	ala	A	alanine
arginine	arg	R	arginine
asparagine	asn	N	asparagine
aspartic acid	asp	D	aspartic_acid
cysteine	cys	C	cysteine
glutamine	gln	Q	glutamine
glutamic acid	glu	E	glutamic_acid
glycine	gly	G	glycine
histidine	his	H	histidine
isoleucine	ile	I	isoleucine
leucine	leu	L	leucine
lysine	lys	K	lysine
methionine	met	M	methionine
phenylalanine	phe	F	phenylalanine
proline	pro	P	proline
serine	ser	S	serine
threonine	thr	T	threonine
tryptophan	trp	W	tryptophan
tyrosine	tyr	Y	tyrosine
valine	val	V	valine
